{
    "51": 10001,
    "52": 10002,
    "53": 10003,
    "54": 10004,
    "55": 10005,
    "56": 10006,
    "57": 10007,
    "58": 10008,
    "59": 10009,
    "60": 10010,
    "61": 10011,
    "62": 10012,
    "63": 10013,
    "71": 14001,
    "72": 14002,
    "73": 14003,
    "74": 14004,
    "75": 15001,
    "76": 15002,
    "77": 15003,
    "79": 15005,
    "80": 15006,
    "81": 15007,
    "82": 15008,
    "83": 15009,
    "84": 15010,
    "85": 15011,
    "86": 15012,
    "87": 15013,
    "88": 15014,
    "89": 15015,
    "90": 15016,
    "91": 15017,
    "92": 15018,
    "93": 15019,
    "94": 15020,
    "95": 15021,
    "96": 15022,
    "97": 15023,
    "98": 15024
}